1 1 1 1 1 1 1 1 1 1 1 1 1 1 1 1
1 0 0 0 0 0 0 5 5 5 5 0 0 0 0 1 
1 0 0 0 0 0 0 5 4 4 5 0 0 0 0 1
1 0 0 0 0 0 0 5 4 4 5 0 0 0 0 1
1 0 0 0 0 0 0 5 5 5 5 0 0 0 0 1
1 0 0 0 0 0 0 0 0 0 0 0 0 0 0 1
1 0 0 0 0 3 3 3 3 3 3 0 0 0 0 1
1 0 0 0 0 3 2 2 2 2 3 0 0 0 0 1
1 0 0 0 0 3 2 2 2 2 3 0 0 0 0 1
1 0 0 0 0 3 2 2 2 2 3 0 0 0 0 1
1 0 0 0 0 3 2 2 2 2 3 0 0 0 0 1
1 1 1 1 1 1 1 1 1 1 1 1 1 1 1 1